Name	title	coding
t3_qo0c3s	BTM salary upon graduation?	o
t3_qq9nd3	Failed Math 208 Midterm	c
t3_qp4jb2	Canadian citizen ship	o
t3_qrxwm5	Study permit	o
t3_qqpo5q	Don’t go to Concordia for arts	o
t3_qnf3mt	"To do checklist on student centre after I applied (I'm international so it asks for like visa expense documents, etc), do I need to do it before or after I have a decision?"	o
t3_qoxt8d	What would people say is the easiest math course to take a Concordia?	c
t3_qple7p	Did not meet the requirements on conditional offer	o
t3_qr8lnd	Stop Smoking within the Indicated Line	o
t3_qplp47	Conconrdia Engr courses attendance policy	c
t3_qouo3n	COMM 205	c
t3_qq7zbj	COMP 232 + 233 in one semester?	c
t3_qp6cg0	Is there and art club or something that students from outside of fine arts can join?	o
t3_qo1ena	Anyone down to practice leetcode and tech interview questions?	o
t3_qpr2og	"Guys , what’s the best website/app to find apartments for rent for students?"	r
t3_qnrgvm	Coffee shops to study!	f
t3_qr9eyp	Does COMP 248 have a curve?	c
t3_qs1y9e	Msc Finance admission JMBS	o
t3_qqb0oc	Comp 218	c
t3_qqg6b9	How will theology department tests work when we return to school in January?	o
t3_qmry9i	"Relevent post, this scammer is around Concordia (St. Catherines just west of rue Guy)"	o
t3_qpl3jr	Is graduate course withdrawal deadline today?	o
t3_qmopar	Survey for our Statistics Class! :)	o
t3_qqk482	How much financial aid money do I lose if I disc a class?	o
t3_qqyev4	Transferring	o
t3_qq5d1b	COMP 335 Syllabus	c
t3_qq9ztp	Surveys about Hair Salons and Nail Salons for COMM 210 Class	c
t3_qp5j44	Concordia or uwindsor	o
t3_qqm6kf	AFE Financial Aid Question	o
t3_qrb4vm	interesting majors	o
t3_qpvjxz	DISC Inquiry	o
t3_qrsgag	Course difficulty PHYS 205 vs PHYS 206?	c
t3_qoi8u0	Account Balance	o
t3_qqg2sg	Minimum grade for a prerequisite course	c
t3_qoumus	Comm 215	c
t3_qncmqz	Anyone know any good psychoanalysts around?	o
t3_qo4ris	DISC on DISC date?	o
t3_qrb93k	is the non credit french course better than the one with credits in concordia?	c
t3_qne2cy	Just submitted my application for fall 2022!!!	o
t3_qmx5wu	What's going on at Space Concordia	o
t3_qrunr8	Scholarly articles	o
t3_qo26js	Permanent code international student.	o
t3_qmz7j7	Can anyone share the Econ 301 course outline with me?	c
t3_qratfw	Late DISC an elective	o
t3_qs1jh0	Communications program?	o
t3_qphn14	Chance of concentration mechanical Beng to Soen	o
t3_qndfs9	Is there a limit to how many DISC you can have?	o
t3_qpl6dx	Work-study program	o
t3_qr3jm7	Can Concordia produce transcripts for an ongoing course?	c
t3_qr4prk	Health and life sciences BcompSc	c
